"filename", "language", "JSON", "Python", "Cython", "Shell Script", "C", "comment", "blank", "total"
"c:\Users\Fedor\Desktop\Projects\python_projects\pgaiballs\aiballs\__init__.py", "Python", 0, 1, 0, 0, 0, 1, 1, 3
"c:\Users\Fedor\Desktop\Projects\python_projects\pgaiballs\aiballs\__main__.py", "Python", 0, 10, 0, 0, 0, 2, 3, 15
"c:\Users\Fedor\Desktop\Projects\python_projects\pgaiballs\aiballs\ai.py", "Python", 0, 10, 0, 0, 0, 1, 5, 16
"c:\Users\Fedor\Desktop\Projects\python_projects\pgaiballs\aiballs\aiballs.py", "Python", 0, 6, 0, 0, 0, 2, 4, 12
"c:\Users\Fedor\Desktop\Projects\python_projects\pgaiballs\aiballs\background.py", "Python", 0, 51, 0, 0, 0, 0, 16, 67
"c:\Users\Fedor\Desktop\Projects\python_projects\pgaiballs\aiballs\ball.py", "Python", 0, 97, 0, 0, 0, 9, 33, 139
"c:\Users\Fedor\Desktop\Projects\python_projects\pgaiballs\aiballs\button.py", "Python", 0, 34, 0, 0, 0, 0, 11, 45
"c:\Users\Fedor\Desktop\Projects\python_projects\pgaiballs\aiballs\code_error.py", "Python", 0, 48, 0, 0, 0, 0, 16, 64
"c:\Users\Fedor\Desktop\Projects\python_projects\pgaiballs\aiballs\collision.c", "C", 0, 0, 0, 0, 8070, 1517, 372, 9959
"c:\Users\Fedor\Desktop\Projects\python_projects\pgaiballs\aiballs\collision.pyx", "Cython", 0, 0, 131, 0, 0, 4, 42, 177
"c:\Users\Fedor\Desktop\Projects\python_projects\pgaiballs\aiballs\context.py", "Python", 0, 32, 0, 0, 0, 0, 7, 39
"c:\Users\Fedor\Desktop\Projects\python_projects\pgaiballs\aiballs\data\button_theme\defeat_theme.json", "JSON", 35, 0, 0, 0, 0, 0, 0, 35
"c:\Users\Fedor\Desktop\Projects\python_projects\pgaiballs\aiballs\data\button_theme\green_theme.json", "JSON", 35, 0, 0, 0, 0, 0, 0, 35
"c:\Users\Fedor\Desktop\Projects\python_projects\pgaiballs\aiballs\data\button_theme\red_theme.json", "JSON", 35, 0, 0, 0, 0, 0, 0, 35
"c:\Users\Fedor\Desktop\Projects\python_projects\pgaiballs\aiballs\data\button_theme\theme.json", "JSON", 35, 0, 0, 0, 0, 0, 0, 35
"c:\Users\Fedor\Desktop\Projects\python_projects\pgaiballs\aiballs\data\callgrind.profile", "Shell Script", 0, 0, 0, 5479, 0, 0, 561, 6040
"c:\Users\Fedor\Desktop\Projects\python_projects\pgaiballs\aiballs\data\code\test.py", "Python", 0, 3, 0, 0, 0, 1, 0, 4
"c:\Users\Fedor\Desktop\Projects\python_projects\pgaiballs\aiballs\data\level\level.json", "JSON", 21, 0, 0, 0, 0, 0, 3, 24
"c:\Users\Fedor\Desktop\Projects\python_projects\pgaiballs\aiballs\finish.py", "Python", 0, 19, 0, 0, 0, 0, 6, 25
"c:\Users\Fedor\Desktop\Projects\python_projects\pgaiballs\aiballs\finish_scene.py", "Python", 0, 55, 0, 0, 0, 0, 14, 69
"c:\Users\Fedor\Desktop\Projects\python_projects\pgaiballs\aiballs\fps.py", "Python", 0, 11, 0, 0, 0, 2, 3, 16
"c:\Users\Fedor\Desktop\Projects\python_projects\pgaiballs\aiballs\game.py", "Python", 0, 33, 0, 0, 0, 5, 9, 47
"c:\Users\Fedor\Desktop\Projects\python_projects\pgaiballs\aiballs\level.py", "Python", 0, 145, 0, 0, 0, 6, 29, 180
"c:\Users\Fedor\Desktop\Projects\python_projects\pgaiballs\aiballs\level_scene.py", "Python", 0, 108, 0, 0, 0, 2, 20, 130
"c:\Users\Fedor\Desktop\Projects\python_projects\pgaiballs\aiballs\level_selection.py", "Python", 0, 47, 0, 0, 0, 0, 13, 60
"c:\Users\Fedor\Desktop\Projects\python_projects\pgaiballs\aiballs\menu.py", "Python", 0, 46, 0, 0, 0, 0, 14, 60
"c:\Users\Fedor\Desktop\Projects\python_projects\pgaiballs\aiballs\mouse.py", "Python", 0, 27, 0, 0, 0, 2, 6, 35
"c:\Users\Fedor\Desktop\Projects\python_projects\pgaiballs\aiballs\notepad.py", "Python", 0, 20, 0, 0, 0, 0, 7, 27
"c:\Users\Fedor\Desktop\Projects\python_projects\pgaiballs\aiballs\options.py", "Python", 0, 59, 0, 0, 0, 0, 16, 75
"c:\Users\Fedor\Desktop\Projects\python_projects\pgaiballs\aiballs\pause.py", "Python", 0, 26, 0, 0, 0, 0, 6, 32
"c:\Users\Fedor\Desktop\Projects\python_projects\pgaiballs\aiballs\player.py", "Python", 0, 6, 0, 0, 0, 0, 1, 7
"c:\Users\Fedor\Desktop\Projects\python_projects\pgaiballs\aiballs\quit.py", "Python", 0, 20, 0, 0, 0, 0, 7, 27
"c:\Users\Fedor\Desktop\Projects\python_projects\pgaiballs\aiballs\restart.py", "Python", 0, 16, 0, 0, 0, 0, 5, 21
"c:\Users\Fedor\Desktop\Projects\python_projects\pgaiballs\aiballs\scene.py", "Python", 0, 5, 0, 0, 0, 1, 1, 7
"c:\Users\Fedor\Desktop\Projects\python_projects\pgaiballs\aiballs\useraction.py", "Python", 0, 9, 0, 0, 0, 0, 2, 11
"c:\Users\Fedor\Desktop\Projects\python_projects\pgaiballs\aiballs\wall.py", "Python", 0, 27, 0, 0, 0, 0, 7, 34
"c:\Users\Fedor\Desktop\Projects\python_projects\pgaiballs\level1.json", "JSON", 48, 0, 0, 0, 0, 0, 2, 50
"c:\Users\Fedor\Desktop\Projects\python_projects\pgaiballs\level2.json", "JSON", 63, 0, 0, 0, 0, 0, 0, 63
"c:\Users\Fedor\Desktop\Projects\python_projects\pgaiballs\setup.py", "Python", 0, 10, 0, 0, 0, 0, 2, 12
"c:\Users\Fedor\Desktop\Projects\python_projects\pgaiballs\template.json", "JSON", 39, 0, 0, 0, 0, 0, 0, 39
"Total", "-", 311, 981, 131, 5479, 8070, 1555, 1244, 17771